***********
*S*   *   *
*   * * ***
* ***   * *
*   ***   *
*** *E*****
*     *   *
* * *   * *
***********
