**********************************
*          *         *   *      E*
*    *     *    *    *   *  ******
*    *     *    *        *  *    *
*    *******    **********  * *  *
*                        **** *  *
*    ************   *    *  ***  *
*    *          *   *    *       *
*    *******    *   *    ***  *  *
*               *   *      *  *  *
*    ************   *****  *  *  *
*    *          *       *  *     *
*    *******    *****   *  ****  *
*S                      *        *
**********************************
